5
##########
#A.a.@...#
#B.b.@...#
#Y.y.@...#
#Z.z.@...#
##########
